ostan,shahrestan,fam,pop,m,f,lat,lon
مرکزي,اراک,188180,591756,300245,291511,34.0865203,49.6888415
مرکزي,آشتيان,5582,16357,8238,8119,34.5216784,50.0018687
مرکزي,تفرش,8588,24913,12390,12523,34.6927402,50.0146963
مرکزي,خمين,34611,105017,52976,52041,31.5351472,49.9515693
مرکزي,دليجان,16453,51621,26372,25249,33.9880486,50.6862901
مرکزي,ساوه,87444,283538,144871,138667,35.0206133,50.3584834
مرکزي,شازند,38214,117571,59138,58433,33.9293155,49.4070049
مرکزي,محلات,18436,55342,28063,27279,13.95,45.616667
مرکزي,زرنديه,20483,63907,32457,31450,35.3643977,50.3429694
مرکزي,کميجان,11339,36441,18485,17956,34.7207822,49.3219622
مرکزي,خنداب,16792,54018,27862,26156,15.6569172,87.6379394
مرکزي,فراهان,9744,28994,14654,14340,34.6213325,49.631180053816514
گيلان,آستارا,28742,91257,45858,45399,38.4193239,48.8715278
گيلان,آستانه اشرفيه,38824,108130,54367,53763,37.2607374,49.9456642
گيلان,بندرانزلي,48193,139016,69228,69788,37.4592329,49.523213
گيلان,طوالش,61055,200649,101222,99427,37.89906,48.827541055793816
گيلان,رشت,321703,956971,478678,478293,37.2038369,49.563278
گيلان,رودبار,31146,94720,47936,46784,36.8219055,49.4268249
گيلان,رودسر,51586,147399,73711,73688,37.1381592,50.2927862
گيلان,صومعه سرا,41975,125074,62317,62757,37.301672,49.3147378
گيلان,فومن,31209,92310,46129,46181,37.2273234,49.3141954
گيلان,لنگرود,49351,140686,70675,70011,34.5275292,50.9793732
گيلان,لاهيجان,58378,167544,84195,83349,30.4538442,55.9088085
گيلان,شفت,18416,54226,27212,27014,37.1703562,49.4027782
گيلان,املش,15306,43225,21561,21664,37.0961905,50.1844452
گيلان,رضوانشهر,22246,69865,34974,34891,37.5479126,49.1395774
گيلان,سياهكل,16351,46975,23278,23697,37.1521893,49.8716407
گيلان,ماسال,16901,52649,26256,26393,37.3640801,49.1328792
مازندران,آمل,133034,401639,202502,199137,20.8114158,72.9560202
مازندران,بابل,174351,531930,267777,264153,32.6319335,44.5629362
مازندران,بهشهر,55140,168769,85319,83450,36.6911785,53.543415
مازندران,تنكابن,56636,166132,83213,82919,36.840058549999995,50.83784316824561
مازندران,رامسر,25312,74179,37220,36959,36.9225518,50.6431897
مازندران,سارئ,165467,504298,253451,250847,36.5659598,53.0587229
مازندران,سوادكوه,14956,43913,22197,21716,36.0187685,53.0445403
مازندران,قائم شهر,102950,309199,155247,153952,36.4636399,52.8579311
مازندران,نور,39350,121531,61228,60303,36.5732661,52.0101
مازندران,نوشهر,45759,138913,70275,68638,36.6508069,51.5034126
مازندران,بابلسر,44482,135191,67443,67748,36.7008777,52.6481047
مازندران,محمودآباد,32810,98407,50046,48361,37.3659163,45.130571
مازندران,نكا,38178,119511,60094,59417,31.9975683,-9.0360833
مازندران,چالوس,39105,116542,59097,57445,36.6506329,51.4223717
مازندران,جويبار,25278,77576,39390,38186,34.70424,69.2224038
مازندران,گلوگاه,13147,40078,20249,19829,36.7283914,53.8088538
مازندران,فريدونكنار,20066,60031,30531,29500,36.6858,52.5265
مازندران,عباس آباد,17345,52832,26865,25967,33.4133638,50.1003408
مازندران,مياندورود,18253,55053,27647,27406,36.663060349999995,53.21220652205355
مازندران,سيمرغ,6636,19376,9751,9625,36.580532,52.8097463
مازندران,سوادکوه شمالي,8476,24834,12475,12359,36.2531276,52.886813806768046
مازندران,کلاردشت,8067,23648,11981,11667,36.5055519,51.1587669
آذربايجان شرقي,اهر,46202,154530,77756,76774,38.4774934,47.0662215
آذربايجان شرقي,تبريز,563660,1773033,897157,875876,38.5509297,44.9633826
آذربايجان شرقي,سراب,38446,125341,64578,60763,37.9407851,47.5374867
آذربايجان شرقي,مراغه,80261,262604,133740,128864,37.3916705,46.2397524
آذربايجان شرقي,مرند,75711,244971,124646,120325,38.4306358,45.7741
آذربايجان شرقي,ميانه,57665,182848,94355,88493,37.4284538,47.7057976
آذربايجان شرقي,هشترود,17173,57199,29608,27591,37.4758937,47.0499618
آذربايجان شرقي,بناب,42325,134892,68457,66435,37.3386053,46.0592907
آذربايجان شرقي,بستان آباد,27647,94769,49047,45722,37.8429496,46.8339774
آذربايجان شرقي,شبستر,43982,135421,68050,67371,38.1783704,45.7002363
آذربايجان شرقي,کليبر,14145,46125,23545,22580,38.8653368,47.038217
آذربايجان شرقي,هريس,20639,69093,34722,34371,37.8264601,47.5151485
آذربايجان شرقي,جلفا,19443,61358,31562,29796,38.9376054,45.6252101
آذربايجان شرقي,ملکان,33598,111319,57666,53653,37.1429593,46.104082
آذربايجان شرقي,آذرشهر,35364,110311,56028,54283,37.7577189,45.9784018
آذربايجان شرقي,اسکو,50674,158270,80561,77709,37.9163003,46.1243894
آذربايجان شرقي,چاراويماق,9016,31071,15982,15089,37.055143599999994,47.14785118078131
آذربايجان شرقي,ورزقان,16273,52650,27001,25649,38.5087607,46.6487801
آذربايجان شرقي,عجب شير,20608,70852,38188,32664,37.4770929,45.8936922
آذربايجان شرقي,خداآفرين,10196,32995,16751,16244,39.08118775,46.94414641819588
آذربايجان غربي,اروميه,304306,1040565,527278,513287,35.6978905,51.3796759
آذربايجان غربي,پيرانشهر,34560,138864,70967,67897,36.6994559,45.140337
آذربايجان غربي,خوئ,101130,348664,176634,172030,38.5504343,44.95354
آذربايجان غربي,سردشت,31049,118849,60447,58402,36.1553184,45.4799637
آذربايجان غربي,سلماس,53907,196546,100817,95729,38.1969035,44.7685015
آذربايجان غربي,ماكو,27009,94751,48623,46128,13.5102105,22.6742679
آذربايجان غربي,مهاباد,65562,236849,119308,117541,33.5252176,52.2132573
آذربايجان غربي,مياندوآب,83234,273949,141296,132653,37.0085898,46.0550939
آذربايجان غربي,نقده,37481,127671,64587,63084,36.9555967,45.3878933
آذربايجان غربي,بوكان,74250,251409,127379,124030,35.3221017,45.6935321
آذربايجان غربي,شاهين دژ,27669,92456,46461,45995,36.6784386,46.5656627
آذربايجان غربي,تكاب,23482,80556,40235,40321,34.5764171,67.4973499
آذربايجان غربي,اشنويه,19336,73886,37188,36698,37.0418235,45.0983499
آذربايجان غربي,چالدران,11970,45060,23036,22024,39.0651269,44.3844026
آذربايجان غربي,پلدشت,11537,42170,21602,20568,39.3493344,45.0699174
آذربايجان غربي,چايپاره,13718,47292,24071,23221,37.0351416,47.81089266884206
آذربايجان غربي,شوط,15756,55682,28390,27292,39.2178874,44.7711898
کرمانشاه,اسلام آبادغرب,40911,140876,71369,69507,34.2930003,46.9378837
کرمانشاه,کرمانشاه,323291,1083833,548326,535507,34.3239414,47.0735891
کرمانشاه,پاوه,18471,60431,30459,29972,35.0458307,46.3622191
کرمانشاه,سرپل ذهاب,23696,85342,42874,42468,34.4607687,45.863763
کرمانشاه,سنقر,25554,81661,41185,40476,34.7832217,47.5988073
کرمانشاه,قصرشيرين,6903,23929,12747,11182,37.1509024,46.1094402
کرمانشاه,کنگاور,23253,76216,38417,37799,34.5051774,47.9658794
کرمانشاه,گيلانغرب,16570,57007,28830,28177,34.1411088,45.9140759
کرمانشاه,جوانرود,20592,75169,38294,36875,34.8039724,46.4920807
کرمانشاه,صحنه,21788,70757,35715,35042,34.4812132,47.6935934
کرمانشاه,هرسين,22506,78350,39544,38806,34.2721,47.5861
کرمانشاه,ثلاث باباجاني,9270,35219,17988,17231,34.7312742,46.1777575
کرمانشاه,دالاهو,10266,35987,17887,18100,34.2827909,46.2436869
کرمانشاه,روانسر,13790,47657,24380,23277,34.7161309,46.6508369
خوزستان,آبادان,85015,298090,149510,148580,30.3636097,48.2591475
خوزستان,انديمشک,48636,171412,87649,83763,32.458325,48.3521137
خوزستان,اهواز,362480,1302591,656830,645761,30.4046053,48.203769
خوزستان,ايذه,48682,198871,99521,99350,31.8303661,49.8685539
خوزستان,بندرماهشهر,81211,296271,149664,146607,30.5577268,49.1997454
خوزستان,بهبهان,51838,180593,91889,88704,30.5942065,50.2434128
خوزستان,خرمشهر,47380,170976,85245,85731,30.4333105,48.1779858
خوزستان,دزفول,125351,443971,229800,214171,32.3780257,48.4032064
خوزستان,دشت آزادگان,26558,107989,54708,53281,35.6561369,51.3935259
خوزستان,رامهرمز,30591,113776,57642,56134,31.2780254,49.6020152
خوزستان,شادگان,36031,138480,70314,68166,33.5252898,50.4156707
خوزستان,شوشتر,50878,192028,98384,93644,32.0547874,48.8456666
خوزستان,مسجدسليمان,30115,113419,57659,55760,38.0869539,46.28169783403382
خوزستان,شوش,55194,205720,104705,101015,32.2003687,48.2489839
خوزستان,باغ ملک,25872,105384,53587,51797,31.5247494,49.8868966
خوزستان,اميديه,25123,92335,46761,45574,30.7590395,49.7040115
خوزستان,لالي,9200,37963,19564,18399,32.3306321,49.0944
خوزستان,هنديجان,10636,38762,19626,19136,30.2363224,49.7122886
خوزستان,رامشير,14113,54004,27381,26623,30.8939518,49.4093497
خوزستان,گتوند,16901,65468,33753,31715,32.2449183,48.8126036
خوزستان,انديکا,11578,47629,24261,23368,32.206896,49.4439
خوزستان,هفتکل,5908,22119,11193,10926,31.4526,49.5255
خوزستان,هويزه,9449,38886,20127,18759,31.462778,48.0755697
خوزستان,باوي,25597,96484,48662,47822,31.3300077,48.6897054
خوزستان,حميديه,13598,53762,27563,26199,31.4808215,48.4353791
خوزستان,آغاجاري,4961,17654,8712,8942,30.6995647,49.8285336
خوزستان,کارون,27749,105872,53964,51908,32.0482929,48.8330108
فارس,آباده,31672,100831,50991,49840,30.9477854,50.909593
فارس,استهبان,20890,68850,35001,33849,29.1252321,54.0405113
فارس,اقليد,27421,93763,47635,46128,30.8925778,52.688496
فارس,جهرم,70187,228532,119090,109442,28.4961762,53.5593366
فارس,داراب,59525,201489,102520,98969,28.753194,54.548149
فارس,سپيدان,26381,91049,46273,44776,30.2623521,51.9836519
فارس,شيراز,567567,1869001,942444,926557,29.6060218,52.5378041
فارس,فسا,61509,205187,104246,100941,28.9366395,53.6510677
فارس,فيروزآباد,37453,121417,61246,60171,28.845604,52.5727236
فارس,کازرون,76227,266217,134534,131683,29.6203251,51.6520826
فارس,لارستان,60410,213920,109754,104166,27.6619203,54.3229561
فارس,مرودشت,94699,323434,166055,157379,29.8762905,52.8062895
فارس,ممسني,35060,117527,59535,57992,30.07206305,51.42286259817526
فارس,ني ريز,34771,113291,57358,55933,29.1972504,54.3267782
فارس,لامرد,25837,91782,45461,46321,27.333426,53.1816105
فارس,بوانات,15874,50418,25938,24480,30.4738825,53.6228281
فارس,ارسنجان,12878,42725,21700,21025,29.914968,53.3089761
فارس,خرم بيد,15080,50522,25659,24863,30.743668,53.1656484
فارس,زرين دشت,20328,73199,37110,36089,35.6230645,52.6476431
فارس,قيروکارزين,20508,71203,36665,34538,28.4100677,53.228231192237104
فارس,مهر,17262,64827,32853,31974,27.5514645,52.8821254
فارس,فراشبند,12604,45459,22926,22533,28.8553783,52.0946443
فارس,پاسارگاد,8813,30118,15373,14745,29.5968569,52.4801445
فارس,خنج,10708,41359,20638,20721,27.8899259,53.4367822
فارس,سروستان,11653,38114,19505,18609,29.2721889,53.22157
فارس,رستم,12668,44386,21874,22512,34.3516924,72.2833806
فارس,گراش,15155,53907,27602,26305,27.6701538,54.1378384
فارس,کوار,23013,83883,43244,40639,29.2003014,52.6926076
فارس,خرامه,16874,54864,28021,26843,29.498294,53.3122486
كرمان,بافت,26543,84103,42409,41694,29.2340169,56.6056569
كرمان,بم,71338,228241,117868,110373,32.3018217,-64.7603583
كرمان,جيرفت,92937,308858,157935,150923,28.6697367,57.7373382
كرمان,رفسنجان,91511,311214,162723,148491,30.402184,55.9941776
كرمان,زرند,39451,138133,69682,68451,30.8134822,56.5672432
كرمان,سيرجان,95357,324103,167426,156677,29.4458687,55.6704717
كرمان,شهر بابک,31483,103975,54660,49315,30.1172,55.1210
كرمان,كرمان,222356,738724,375918,362806,29.571858,57.301047
كرمان,كهنوج,26276,95848,48479,47369,35.7587093,51.2315662
كرمان,بردسير,25315,81983,41675,40308,29.9283973,56.5717384
كرمان,راور,13281,43198,21666,21532,31.2676737,56.8069974
كرمان,عنبرآباد,23409,82438,41490,40948,28.4779105,57.844051
كرمان,منوجان,18352,65705,32833,32872,27.4014947,57.4949725
كرمان,كوهبنان,6413,21205,10751,10454,31.4126,56.2801
كرمان,رودبار جنوب,27428,105992,53214,52778,28.0185535,58.0006441
كرمان,قلعه گنج,20521,76495,37989,38506,27.5239005,57.8771387
كرمان,ريگان,23983,88410,45118,43292,35.2127778,59.6741667
كرمان,رابر,11513,35362,17762,17600,29.2907749,56.914165
كرمان,فهرج,17195,67096,34750,32346,28.9454742,58.8845357
كرمان,انار,10918,36897,19177,17720,30.8724332,55.2720954
كرمان,نرماشير,16182,54228,27635,26593,28.9513934,58.6963456
كرمان,فارياب,9817,34000,17026,16974,27.4703517,57.0805811
كرمان,ارزوئيه,11142,38510,19502,19008,28.4568592,56.3634502
خراسان رضوئ,تايباد,30718,117564,60007,57557,34.7401763,60.7755127
خراسان رضوئ,تربت حيدريه,68927,224626,114968,109658,35.2740853,59.2194494
خراسان رضوئ,تربت جام,71802,267671,135477,132194,35.2432546,60.626313
خراسان رضوئ,درگز,22778,72355,36505,35850,37.4470313,59.1064876
خراسان رضوئ,سبزوار,95553,306310,153187,153123,36.2134053,57.6808799
خراسان رضوئ,قوچان,52851,174495,88656,85839,37.105993,58.5108056
خراسان رضوئ,كاشمر,52778,168664,85004,83660,35.2444908,58.464248
خراسان رضوئ,گناباد,27607,88753,44647,44106,34.350302,58.6859427
خراسان رضوئ,مشهد,1021068,3372660,1693602,1679058,36.2974945,59.6059232
خراسان رضوئ,نيشابور,142545,451780,227133,224647,33.5481855,55.0591844
خراسان رضوئ,چناران,45105,155013,80956,74057,36.6483961,59.1185005
خراسان رضوئ,خواف,36399,138972,70328,68644,34.5723166,60.1440373
خراسان رضوئ,سرخس,26932,97519,49813,47706,36.5399097,61.1564431
خراسان رضوئ,فريمان,28641,99001,50044,48957,35.701215,59.8465304
خراسان رضوئ,بردسكن,23732,75631,38332,37299,35.2611338,57.9685311
خراسان رضوئ,رشتخوار,17566,60689,30817,29872,34.9751301,59.6245967
خراسان رضوئ,كلات,10708,36237,18405,17832,36.5026885,44.8737788
خراسان رضوئ,خليل آباد,16684,51701,26251,25450,31.783809,54.2253922
خراسان رضوئ,مه ولات,15844,51409,26027,25382,34.914812,58.671018194186
خراسان رضوئ,بجستان,10011,31207,15683,15524,34.5163087,58.1834619
خراسان رضوئ,بينالود,21861,69640,35980,33660,36.4277231,58.8454207
خراسان رضوئ,فيروزه,11783,37539,19064,18475,37.355711,57.2469163
خراسان رضوئ,جغتاي,14923,49175,25081,24094,36.638031,57.0743721
خراسان رضوئ,زاوه,20063,67695,34183,33512,35.2722222,59.4658333
خراسان رضوئ,جوين,16738,54488,27632,26856,36.003903,49.8522387
خراسان رضوئ,باخرز,15525,54615,27580,27035,34.9941781,60.3148224
خراسان رضوئ,خوشاب,11883,37181,18751,18430,35.9908,47.5782
خراسان رضوئ,داورزن,7678,21911,11072,10839,36.3512877,56.8762448
اصفهان,اردستان,14140,42105,21281,20824,33.3797762,52.3724967
اصفهان,اصفهان,707870,2243249,1133446,1109803,32.6707877,51.6650002
اصفهان,خميني شهر,98269,319727,164787,154940,32.6938201,51.5254892
اصفهان,خوانسار,10923,33049,16446,16603,33.22692,50.3146044
اصفهان,سميرم,22530,74109,37886,36223,31.4136588,51.5708254
اصفهان,فريدن,15547,49890,25685,24205,32.6635001,51.7046931
اصفهان,فريدونشهر,10688,35654,18171,17483,35.7118395,51.4206157
اصفهان,فلاورجان,77213,249814,128785,121029,32.5576772,51.5079153
اصفهان,شهرضا,50983,159797,81640,78157,32.0116032,51.8651719
اصفهان,کاشان,112258,364482,184806,179676,38.4750705,46.9866907
اصفهان,گلپايگان,30419,90086,45913,44173,35.7018971,51.4531354
اصفهان,لنجان,81101,262912,133557,129355,32.3758667,51.212971077431824
اصفهان,نايين,13378,39261,19618,19643,32.8610688,53.085985
اصفهان,نجف آباد,98513,319205,161791,157414,33.3322314,48.5924864
اصفهان,نطنز,14959,43977,22322,21655,33.5136336,51.9140078
اصفهان,شاهين شهر و ميمه,73981,234667,117467,117200,33.1272,51.5150
اصفهان,مبارکه,46936,150441,77029,73412,32.3424135,51.5046633
اصفهان,آران وبيدگل,32050,103517,52644,50873,34.0699819,51.4763424
اصفهان,تيران وکرون,22704,71575,36701,34874,32.707729799999996,51.14803369603792
اصفهان,چادگان,9833,32479,16554,15925,32.7743148,50.62360837551181
اصفهان,دهاقان,11118,34511,17571,16940,31.9344047,51.6547247
اصفهان,برخوار,37623,122419,63109,59310,33.0175372,51.648022076342585
اصفهان,خور و بيابانک,6420,19761,9977,9784,33.7761331,55.0828304
اصفهان,بوئین و میاندشت,8026,24163,12291,11872,33.0817,50.1601
سيستان و بلوچستان,ايرانشهر,62625,254314,127692,126622,27.2069903,60.6882515
سيستان و بلوچستان,چابهار,68147,283204,144482,138722,35.7293738,51.7550629
سيستان و بلوچستان,خاش,48396,173821,87230,86591,28.2203911,61.2137052
سيستان و بلوچستان,زابل,43701,165666,82996,82670,32.3068942,67.129904
سيستان و بلوچستان,زاهدان,168480,672589,342524,330065,29.4928874,60.8503017
سيستان و بلوچستان,سراوان,50524,191661,96589,95072,27.3651673,62.3390963
سيستان و بلوچستان,نيك شهر,37207,141894,70977,70917,36.8349937,54.4513559
سيستان و بلوچستان,سرباز,45910,186165,92894,93271,26.6321167,61.2570288
سيستان و بلوچستان,کنارک,23600,98212,52768,45444,25.4039,60.3733
سيستان و بلوچستان,زهك,20055,74896,37763,37133,55.766182,55.511276
سيستان و بلوچستان,هيرمند,16559,63979,32359,31620,35.7556027,51.2040936
سيستان و بلوچستان,دلگان,16551,67857,33575,34282,27.417637,59.52108512147857
سيستان و بلوچستان,مهرستان,17407,70579,35031,35548,27.1310393,61.6746528
سيستان و بلوچستان,سيب و سوران,21665,85095,42196,42899,27.2871579,61.9997051
سيستان و بلوچستان,نيمروز,12700,48471,24542,23929,30.7753811,62.4793088
سيستان و بلوچستان,هامون,11380,41017,20467,20550,30.931745300000003,61.165171636491465
سيستان و بلوچستان,ميرجاوه,11853,45357,22978,22379,29.0149246,61.4540744
سيستان و بلوچستان,قصرقند,15524,61076,30325,30751,26.2394578,60.7419235
سيستان و بلوچستان,فنوج,12604,49161,24543,24618,26.575768,59.6398773
كردستان,بانه,43772,158690,80622,78068,35.9946631,45.8843225
كردستان,بيجار,27759,89162,44832,44330,35.8720805,47.5999996
كردستان,سقز,64384,226451,113925,112526,36.2427456,46.2705227
كردستان,سنندج,152532,501402,253347,248055,35.3126047,46.9978639
كردستان,قروه,42905,140192,70865,69327,35.1679005,47.800886
كردستان,مريوان,55603,195263,99956,95307,35.5219063,46.1758889
كردستان,ديواندره,21216,80040,40810,39230,35.9159662,47.0193315
كردستان,كامياران,30276,102856,52709,50147,34.7956,46.9368
كردستان,سروآباد,13475,44940,22884,22056,35.3123202,46.3659551
كردستان,دهگلان,19388,64015,32826,31189,35.280039,47.4189871
همدان,تويسركان,33537,101666,51037,50629,34.7956,46.9368
همدان,ملاير,89762,288685,145199,143486,34.2922623,48.8215749
همدان,نهاوند,55542,178787,90571,88216,34.1896877,48.3716218
همدان,همدان,210775,676105,340923,335182,34.973321,48.6555779
همدان,كبودرآهنگ,37567,126062,65433,60629,35.2113,48.7242
همدان,اسدآباد,30387,100901,50991,49910,31.6670247,60.046165
همدان,بهار,36844,119082,60976,58106,25.6440845,85.906508
همدان,رزن,32207,107587,54617,52970,54.6295687,39.7425039
همدان,فامنين,12182,39359,20571,18788,35.1179137,48.9721158
چهارمحال و بختيارئ,بروجن,36238,122483,62141,60342,31.9719093,51.291596
چهارمحال و بختيارئ,شهركرد,93104,315980,159555,156425,32.3257366,50.8497369
چهارمحال و بختيارئ,فارسان,26914,95286,48906,46380,32.2549162,50.5624938
چهارمحال و بختيارئ,لردگان,54825,209681,107240,102441,31.5126237,50.8303948
چهارمحال و بختيارئ,اردل,13066,48880,24828,24052,31.997682,50.6609476
چهارمحال و بختيارئ,كوهرنگ,10859,41535,21456,20079,32.416667,50
چهارمحال و بختيارئ,كيار,15549,50976,26143,24833,36.3280136,37.6507568
چهارمحال و بختيارئ,سامان,11080,34616,17691,16925,35.259467,49.577919
چهارمحال و بختيارئ,بن,8799,28326,14396,13930,4.4137155,114.5653908
لرستان,اليگودرز,38503,137534,70579,66955,33.4035124,49.6921874
لرستان,بروجرد,102258,326452,163828,162624,33.8943281,48.7560936
لرستان,خرم آباد,144958,506471,255781,250690,33.4842109,48.3538276
لرستان,دلفان,40467,143973,74215,69758,34.05929925,47.82280925123226
لرستان,دورود,50140,174508,89090,85418,33.4992998,49.0529575
لرستان,کوهدشت,45155,166658,84441,82217,33.5331808,47.6070512
لرستان,ازنا,22411,74936,38047,36889,33.4568272,49.4537204
لرستان,پلدختر,21303,73744,37462,36282,33.1524187,47.7117493
لرستان,سلسله,21140,75559,38242,37317,35.1293,47.4521
لرستان,دوره,11948,41756,21467,20289,33.5636959,48.0225482
لرستان,رومشکان,10742,39058,19737,19321,33.25602245,47.435591343208635
ايلام,ايلام,64671,235144,119293,115851,33.1545696,46.7576343
ايلام,دره شهر,12012,43708,22310,21398,33.1385109,47.3753599
ايلام,دهلران,16959,65630,34068,31562,32.6914932,47.2674712
ايلام,چرداول,15867,57381,29362,28019,33.789920050000006,46.59609120168016
ايلام,مهران,8471,29797,15306,14491,33.1239454,46.1658505
ايلام,آبدانان,13188,47851,24352,23499,32.9897172,47.4223907
ايلام,ايوان,13820,49491,24867,24624,33.8282411,46.3096374
ايلام,ملكشاهي,6022,21138,10547,10591,33.3952,46.5829
ايلام,سيروان,3989,14404,7349,7055,34.6482023,45.423282
ايلام,بدره,4311,15614,7745,7869,33.3060497,47.0385999
كهگيلويه و بويراحمد,بويراحمد,77569,299885,152996,146889,30.65328585,51.60887613384399
كهگيلويه و بويراحمد,كهگيلويه,32457,131351,66203,65148,30.79,50.55
كهگيلويه و بويراحمد,گچساران,34329,124096,62713,61383,30.3570209,50.7940113
كهگيلويه و بويراحمد,دنا,11706,42539,21467,21072,30.9510646,51.4361135
كهگيلويه و بويراحمد,بهمئي,10028,38136,19406,18730,31.11001595,50.141456499709
كهگيلويه و بويراحمد,چرام,8890,33543,16811,16732,30.750813,50.7419101
كهگيلويه و بويراحمد,باشت,5781,21690,10826,10864,30.3610498,51.1575225
كهگيلويه و بويراحمد,لنده,5560,21812,10964,10848,30.9795975,50.4238799
بوشهر,بوشهر,85523,298594,153512,145082,28.8936645,51.3204877
بوشهر,تنگستان,22080,76706,38970,37736,32.75426435,52.89044750430622
بوشهر,دشتستان,70943,252047,127231,124816,32.6769496,51.7069256
بوشهر,دشتي,24474,86319,43216,43103,36.3148141,45.5079624
بوشهر,دير,16403,60612,30796,29816,64.73627164999999,177.7358336928592
بوشهر,كنگان,27873,107801,69371,38430,21.794782,31.3480026
بوشهر,گناوه,28181,102484,51825,50659,30.4543709,50.8362714
بوشهر,ديلم,9856,34828,17651,17177,31.7774413,48.8661642
بوشهر,جم,19997,70051,36508,33543,18.1850507,-77.3947693
بوشهر,عسلويه,16496,73958,51642,22316,27.4760027,52.6070411
زنجان,ابهر,47329,151528,76678,74850,36.1436784,49.219963
زنجان,خدابنده,47599,164493,83292,81201,35.2479156,59.2671806
زنجان,زنجان,159020,521302,263140,258162,36.515854,48.4777616
زنجان,ايجرود,11317,36641,18578,18063,36.3256782,48.155502247695
زنجان,خرمدره,21215,67951,34338,33613,36.20354,49.1881871
زنجان,طارم,14438,46641,23804,22837,28.1838327,55.7433138
زنجان,ماهنشان,11935,39425,20069,19356,36.7456508,47.6716751
زنجان,سلطانيه,9130,29480,14950,14530,34.4938889,58.9516667
سمنان,دامغان,30296,94190,47122,47068,36.167451,54.3379993
سمنان,سمنان,52011,196521,100943,95578,35.5834074,53.3882906
سمنان,شاهرود,69723,218628,111191,107437,36.4195026,54.9649915
سمنان,گرمسار,25585,77421,39172,38249,35.2222875,52.3383855
سمنان,مهدئ شهر,15226,47475,23844,23631,35.7108029,53.3555769
سمنان,آرادان,4919,13884,7067,6817,35.2478246,52.4928417
سمنان,ميامي,12481,38718,19450,19268,25.7741728,-80.19362
سمنان,سرخه,5330,15523,7867,7656,37.7502402,47.0735214
يزد,اردكان,28216,97960,53513,44447,32.3063333,54.0159678
يزد,بافق,15156,50845,25849,24996,31.5997065,55.3966892
يزد,تفت,14659,43893,22447,21446,31.752049,54.217422
يزد,مهريز,15978,51733,26480,25253,31.5841945,54.4445661
يزد,يزد,195134,656474,334843,321631,31.489462,54.46578718200166
يزد,ميبد,29684,99727,51071,48656,32.2510825,54.0159205
يزد,ابركوه,16026,51552,26666,24886,31.1324814,53.2803103
يزد,اشکذر,9613,32566,17406,15160,32.000526,54.2071804
يزد,خاتم,10811,36562,19146,17416,35.6326205,51.3578743
يزد,بهاباد,5380,17221,8592,8629,31.876794,56.0191037
هرمزگان,ابوموسي,924,7402,5899,1503,25.8859402,55.0313241
هرمزگان,بندرعباس,196220,680366,347202,333164,27.1793466,56.2781423
هرمزگان,بندرلنگه,44398,159358,84680,74678,26.5580832,54.8838151
هرمزگان,قشم,40506,148993,76077,72916,26.9503253,56.2690869
هرمزگان,ميناب,68906,259221,129849,129372,27.1483069,57.0736732
هرمزگان,جاسك,15211,58884,30110,28774,25.6436156,57.7745644
هرمزگان,رودان,34561,124522,62114,62408,27.4413347,57.1909085
هرمزگان,حاجي اباد,20700,69625,35404,34221,37.2134289,49.981494050650355
هرمزگان,بستك,21684,80492,41095,39397,27.1977195,54.3625640
هرمزگان,خمير,16071,56148,28195,27953,30.4300016,73.0448332
هرمزگان,پارسيان,13816,50596,25736,24860,27.2082174,53.0351431
هرمزگان,سيريک,11304,45723,22840,22883,26.5177389,57.1017980
هرمزگان,بشاگرد,9359,35085,17613,17472,26.4566743,57.900767897036474
تهران,تهران,2924208,8737510,4347534,4389976,35.6892523,51.3896004
تهران,دماوند,39373,125480,64552,60928,35.9549208,52.1096123
تهران,رئ,96996,349700,187223,162477,49.4711669,1.3431323
تهران,شميرانات,16107,47279,24645,22634,35.92951255,51.61400843078803
تهران,ورامين,85516,283742,144612,139130,28.4271444,57.723789
تهران,شهريار,226011,744210,379197,365013,35.6589015,51.0586022
تهران,اسلامشهر,168288,548620,279282,269338,35.5478513,51.2318676
تهران,رباط کریم,89271,291516,149072,142444,35.4850737,51.0841778
تهران,پاکدشت,103542,350966,179375,171591,35.4751698,51.6806973
تهران,فيروزكوه,11700,33558,17093,16465,35.7556732,52.7730592
تهران,قدس,96682,316636,162211,154425,36.3596232,55.4412145
تهران,ملارد,115154,377292,193272,184020,35.666763,50.9790423
تهران,پيشوا,25704,86601,43718,42883,35.3058833,51.7252649
تهران,بهارستان,156791,536329,277160,259169,35.8679716,57.5809848
تهران,پرديس,53367,169060,86477,82583,35.7371227,51.8172149
تهران,قرچک,79853,269138,138249,130889,35.4421824,51.5697005
اردبيل,اردبيل,180975,605992,309504,296488,38.4583983,47.9313001
اردبيل,بيله سوار,15114,51404,26440,24964,39.3779114,48.3499706
اردبيل,خلخال,26779,86731,43791,42940,37.6192217,48.5278144
اردبيل,مشگين شهر,45999,149941,76841,73100,38.3979293,47.6764836
اردبيل,گرمي,22349,76901,38935,37966,39.0288619,48.08053
اردبيل,پارس آباد,50083,177601,91956,85645,39.6461735,47.918551
اردبيل,كوثر,6586,22127,11306,10821,31.9206749,35.2123957
اردبيل,نمين,17836,60659,31084,29575,38.4240161,48.4840477
اردبيل,نير,6364,20864,10845,10019,31.4845702,54.1259966
اردبيل,سرعين,5338,18200,9553,8647,38.1493746,48.0746208
قم,قم,383532,1292283,658540,633743,34.6423117,50.8800969
قزوين,بوئين زهرا,36814,122994,63080,59914,35.7679957,50.0579667
قزوين,تاکستان,52917,172636,87881,84755,36.0726006,49.6937027
قزوين,قزوين,188460,596932,303905,293027,35.8369179,50.9428636
قزوين,آبيك,29234,94536,49129,45407,36.0404,50.5446
قزوين,البرز,75922,242865,123908,118957,35.9413239,50.7884216
قزوين,آوج,13818,43798,22596,21202,35.5787119,49.2235344
گلستان,بندرگز,15247,46130,23113,23017,36.7719958,53.9481369
گلستان,تركمن,21315,79978,40231,39747,32.425843,65.663714
گلستان,علي آباد,42725,140709,70385,70324,33.5191494,50.3304419
گلستان,کردکوی,23510,71270,35970,35300,36.691667,54.2
گلستان,گرگان,150649,480541,241700,238841,25.6932827,59.3091295
گلستان,گنبد کاووس,97147,348744,175480,173264,37.2492965,55.1659018
گلستان,مينودشت,22719,75483,37804,37679,37.2288889,55.3747222
گلستان,آق قلا,35989,132733,66535,66198,37.0134841,54.4576664
گلستان,كلاله,32998,117319,58836,58483,37.3833,55.5026
گلستان,آزادشهر,28965,96803,48384,48419,37.0875125,55.1725639
گلستان,راميان,25579,86210,43083,43127,37.0150484,55.1424163
گلستان,مراوه تپه,16211,60953,30427,30526,37.9042755,55.9549173
گلستان,گميشان,18474,68773,34715,34058,37.070099,54.0770422
گلستان,گالیکش,18721,63173,31664,31509,37.2719444,55.4325000
خراسان شمالي,اسفراين,36519,120513,60334,60179,37.0750975,57.5096169
خراسان شمالي,بجنورد,94457,324083,162778,161305,37.4759752,57.3319881
خراسان شمالي,جاجرم,11154,36673,18463,18210,36.9499996,56.3792939
خراسان شمالي,شيروان,43873,146140,73658,72482,39.92770745,48.9301577467449
خراسان شمالي,فاروج,15469,49271,24771,24500,37.2317346,58.2192859
خراسان شمالي,مانه و سملقان,29624,101727,51409,50318,37.55939,56.921302
خراسان شمالي,گرمه,7748,25475,12882,12593,36.9870347,56.2888872
خراسان شمالي,راز و جرگلان,15903,59210,29338,29872,37.9338042,57.1113879
خراسان جنوبي,بيرجند,74657,261324,132182,129142,32.8633961,59.2177294
خراسان جنوبي,درميان,14639,53714,27052,26662,32.835952,59.9023989
خراسان جنوبي,سربيشه,12011,40959,20394,20565,32.573805,59.795754
خراسان جنوبي,قائنات,34794,116181,58420,57761,33.6500639,59.013040329797875
خراسان جنوبي,نهبندان,14185,51449,26278,25171,31.5431543,60.0349456
خراسان جنوبي,سرايان,10329,33312,16629,16683,33.8615755,58.5250488
خراسان جنوبي,فردوس,14302,45523,22783,22740,34.01816,58.1689746
خراسان جنوبي,بشرويه,8255,26064,13116,12948,33.8662098,57.4253814
خراسان جنوبي,زيرکوه,11178,40155,20418,19737,32.312394350000005,51.19188520430032
خراسان جنوبي,خوسف,7492,27600,15645,11955,32.7792099,58.8879164
خراسان جنوبي,طبس,22142,72617,37000,35617,35.672012,139.7347426
البرز,کرج,623801,1973470,999790,973680,35.8121955,51.0073853
البرز,ساوجبلاغ,80953,259973,133503,126470,36.7651739,45.7218136
البرز,نظرآباد,46658,152437,78275,74162,30.9430024,50.9118891
البرز,طالقان,6354,16815,8480,8335,36.177868,50.7655155
البرز,اشتهارد,11731,37876,19605,18271,35.7234469,50.3670608
البرز,فرديس,86619,271829,136682,135147,35.7866258,51.0025424
